 ___________
 |  /      |
 | /       0
 |/       /|
 |         |
 |
_|_
